C 42          ,42        ,							250									
SO							./path_to_the_south_texture
                        WE ./path_to_the_west_texture
EA ./path_to_the_east_texture
F            135,						0,1         
					NO         					 ./path_to_the_north_texture
11111111111                   11111111111
100011110101       111        10000000001
101110001101    1  101        11111111101
111000000001    1  111        10000000001
100000000001   11             10111111111
111111111111       1111111    10000000001
             1111111000001    11111111101
             1000000010001    10000000001   
11            11111S000001    11111111111
11                 1111111               
1111111111111111       
1000000000000001    
1000000000000001      
10000000000000011111
11111111111111111111