

C 42          ,42        ,							250									


SO							./path_to_the_south_texture
                        WE ./path_to_the_west_texture
EA ./path_to_the_east_texture
F            135,						0,1         



					NO         					 ./path_to_the_north_texture

111111
100101
101001
1100N1
111111