

C 42          ,42        ,							250									


SO							./textures/wooden_box.xpm
                        WE ./textures/wooden_box.xpm
EA ./textures/wooden_box.xpm
F            135,						0,1         



					NO         					 ./textures/wooden_box.xpm


11111
10001
11101
10N001
10001
11111
