

C 42          ,42        ,							250									


SO							./path_to_the_south_texture
                        WE ./path_to_the_west_texture
EA ./path_to_the_east_texture
F            135,						0,1         



					NO         					 ./path_to_the_north_texture


11111
10001
11101
10101
1N001
11111
