NO ./path_to_the_north_texture
SO ./path_to_the__texture
WE ./path_to_the_west_texture
EA ./path_to_the_east_texture
F 255.0.0
C 0.0.255

1111111
1000001
1000011
1000001
1011001
100E1011
1011001
10001111111
11000000001
11111111001
11111111011
11111111111
