NO ./path_to_the_north_texture
SO ./path_to_the__texture
WE ./path_to_the_west_texture
EA ./path_to_the_east_texture
F 255.0.0
C 0.0.255

11111111111
10010000001
10100000001
10100000001
10100000001
101000000N1
10100000001
10100000001
10100100001
11000000001
11111111111





