NO ./path_to_the_north_texture
SO ./path_to_the__texture
WE ./path_to_the_west_texture
EA ./path_to_the_east_texture
F 255.0.0
C 0.0.255

1111111
1000001
1000011
1000001
1010001
1000001
1010001
1000W11
1100011
1111111
