WE./textures/my_wall.xpm
NO./textures/greystone.xpm
SO./textures/mossy.xpm
EA./textures/wood.xpm

F 144,238,144
C 225,255,254

        1111111111111111111111111
        1000000000110000000000001
        1011000001110000010000001
        1001000000000000011000001
111111111011000001110000000000001
100000000011000001110111101111111
11110111111111011100000010001
11110111111111011101010010001
11000000110101011100000010001
10000000000000001100000010001
10000000000000001101010010001
11000001110101011111011110011
11110111 1110101 1011110100N1
11111111 1111111 111111111111