WE./textures/we.xpm
NO./textures/no.xpm
SO./textures/so.xpm
EA./textures/ea.xpm

C 150,50,190
F 80,20,90

111111
10E00011
110000011
1 11101111111
11000010000001
1110000111111
10001101
11111111
            11111111111
        11110000001101
        10010001111001
        10000001000011
        11111100011111
   1          111