WE./textures/neon1.xpm
NO./textures/neon2.xpm
SO./textures/neon3.xpm
EA./textures/neon4.xpm

F 111,1,12
C 225,255,254

        1111111111111111111111111
        1000000000110000000000001
        1011000001110000010000001
        1001000000000000011000001       1
111111111011000001110000000000001
100000000011000001110111101111111
1111011111  11011100000010001  1
11110111  1 1101 101010010001  1111
11000000110101011100000010001     1
10000000000000001100000010001     1111
10000000000000001101010010001        1
11000001110101011111011110011        1111111
11110111 1110101 1  1   100W1              1
11111111 1111111 1111111 1111111111111111111