WE./textures/neon1.xpm
NO./textures/neon2.xpm
SO./textures/neon3.xpm
EA./textures/neon4.xpm

F 50,0,100
C 150,75,135

111111
10W00011
110000011
11110111
1000001
11100001
10001101
11111111