WE./textures/we.xpm
NO./textures/no.xpm
SO./textures/so.xpm
EA./textures/ea.xpm

F 50,0,100
C 150,75,135

111111
10E00011
110000011
1 1110111
1100001
11100001
10001101
11111111
           11111111111
        11110000001101
        10010001111001
        10000001000011
        11111100011111
   1          111